This is an exciting day! You have been invited by the board to sit in on a conference about the company's newest product for techno magic. As you open the door, your face contorts in horror to find the Conference Room littered with the unmoving bodies of the board members, killed by magic, and one shivering witness in the corner. This is a tragedy, the company will be thrown into ruin from this loss unless the true murderer can be caught. It is up to you to find the culprit and save Magicorp.

Magicorp
A murder in Magicorp by Cole Damon The story creation year is 2014
Release 1 / Serial number 141103 / Inform 7 build 6L38 (I6/v6.33 lib 6/12N) SD

Conference Room
The room, meant to be your next step in the Magicorp ladder, is now strewn with the bodies of the dead board members with only one living witness in the corner. You will need to find out exactly what happened. Maybe ask the witness about the murders? The Meeting room is to the east and Offices to the north.

You can see witness here.

>w
You can't go that way.

>e
Meeting Room
The Meeting room is a secondary room to meet in if the Conference room is being used, it only has a locker to hold stuff. The Conference room is to the west, and Security room to the east.

You can see Security Door here.

>open locker
You open locker, revealing Base.

>take base
Taken.

>w
Conference Room
The room, meant to be your next step in the Magicorp ladder, is now strewn with the bodies of the dead board members with only one living witness in the corner. You will need to find out exactly what happened. Maybe ask the witness about the murders? The Meeting room is to the east and Offices to the north.

You can see witness here.

>n
Offices
This room is the offices for the basic workers, filled with closed work stations. it seems like all are oblivious to what happened in the conference room. It would not help to talk to these guys, so just focus on finding the culprit. The Conference Room is to the south, the Guard's Office is to the east, and the Hallway is to the west.

You can see work stations (closed) here.

>open work stations
You open work stations, revealing Crystal.

>take crystal
Taken.

>w
Hallway
This is just the regular hallway in between most elevators and rooms. The Elevator is to the west, Offices to the east, and a closet to the north.

You can see broom door here.

>n
(first opening broom door)
The door to the closet, there really seems to be no need to go in there right now though.

>n
(first opening broom door)
The door to the closet, there really seems to be no need to go in there right now though.

>w
Elevator
The elevator going to other floors, but its locked, so this seems to be a dead end. The Hallway is to the east.

You can see Projector here.

>take projector
Taken.

>comebine base with and crystal
That's not a verb I recognise.

>combine base with and crystal
You can't see any such thing.

>combine base and crystal
You can't use multiple objects with that verb.

>combine base wtih crystal
I didn't understand that sentence.

>combine base with crystal
You fuse together Base and Crystal.

You now have a a Powered machine.

>combine machine with projector
You fuse together the Powered machine and Projector.

You now have a Imagecaster.

>e
Hallway
This is just the regular hallway in between most elevators and rooms. The Elevator is to the west, Offices to the east, and a closet to the north.

You can see broom door here.

>n
(first opening broom door)
Closet
This is just a dark closet, not much is in here besides a closed mop bucket. The Hallway is to the south.

You can see broom door and mop bucket (closed) here.

>s
(first opening broom door)
Closet
This is just a dark closet, not much is in here besides a closed mop bucket. The Hallway is to the south.

You can see broom door and mop bucket (closed) here.

>e
You can't go that way.

>s
(first opening broom door)
Closet
This is just a dark closet, not much is in here besides a closed mop bucket. The Hallway is to the south.

You can see broom door and mop bucket (closed) here.

* * *

>n
Offices
This room is the offices for the basic workers, filled with closed work stations. it seems like all are oblivious to what happened in the conference room. It would not help to talk to these guys, so just focus on finding the culprit. The Conference Room is to the south, the Guard's Office is to the east, and the Hallway is to the west.

You can see work stations (closed) here.

>w
Hallway
This is just the regular hallway in between most elevators and rooms. The Elevator is to the west, Offices to the east, and a closet to the north.

>n
You can't go that way.

>n
You can't go that way.

>say portasum openab
The words were said correctly, but it seems that they also need the source material of the spell to channel magic through while .

* * *

>n
You can't go that way.

>s
Hallway
This is just the regular hallway in between most elevators and rooms. The Elevator is to the east, Offices to the west, and a closet to the north.

>e
Elevator
The elevator going to other floors, but its locked, so this seems to be a dead end.

>s
You can't go that way.

>take note
You can't see any such thing.

* * *

>n
You can't go that way.

>open bucket
You open mop bucket, revealing Spell Note.

>x spell note
A scroll with a low level portal spell that even you could cast, it says "portasum openab."

>portasum openab
The words were said correctly, but it seems that they also need the source material of the spell to channel magic through while .

>take spell note
Taken.

>portasum openab
In a clap of thunder and a bright flash, a glowing portal appears to the north.

>drop spell note
Dropped.

>x portal
Dark Arts Inc
Dark Arts Inc is Magicorp's biggest rival, of course they would send some one to sabotage you.

    *** The portal sucks you in but on the other side, oh, no. This is Dark Arts Inc, Magicorp's biggest rival in techno magic innovation! You are met with magicians pointing wands at you, and one with a black hood on. Its a trap! The murderer knew you were following him and was expecting you to come through. The portal has closed behind you and theres no escape. It seems all is lost for Magicorp now :( ***

Would you like to RESTART, RESTORE a saved game, QUIT or UNDO the last command?

* * *

>n
Offices
This room is the offices for the basic workers, filled with closed work stations. it seems like all are oblivious to what happened in the conference room. It would not help to talk to these guys, so just focus on finding the culprit. The Conference Room is to the south, the Guard's Office is to the east, and the Hallway is to the west.

You can see work stations (closed) here.

>x crystal
You can't see any such thing.

>take crystal
You can't see any such thing.

>s
Conference Room
The room ment to be your next step in the Magicorp ladder, now strewn with the bodies of the dead board members with only one living witness in the corner. You will need to find out exactly what happened. Maybe ask the witness about the murders? The Meeting room is to the east and Offices to the north.

You can see witness here.

>s
You can't go that way.

>e
Meeting Room
The Meeting room is a secondary room to meet in if the Conference room is being used, it only has a locker to hold stuff. The Conference room is to the west, and Security room to the east.

You can see Security Door here.

>x locker
A locker used to store items in. Some times people forget things in there, so make sure you don't

>take base
You can't see any such thing.

>l
Meeting Room
The Meeting room is a secondary room to meet in if the Conference room is being used, it only has a locker to hold stuff. The Conference room is to the west, and Security room to the east.

You can see Security Door here.

>w
Conference Room
The room ment to be your next step in the Magicorp ladder, now strewn with the bodies of the dead board members with only one living witness in the corner. You will need to find out exactly what happened. Maybe ask the witness about the murders? The Meeting room is to the east and Offices to the north.

You can see witness here.

>n
Offices
This room is the offices for the basic workers, filled with closed work stations. it seems like all are oblivious to what happened in the conference room. It would not help to talk to these guys, so just focus on finding the culprit. The Conference Room is to the south, the Guard's Office is to the east, and the Hallway is to the west.

You can see work stations (closed) here.

>w
Hallway
This is just the regular hallway in between most elevators and rooms. The Elevator is to the east, Offices to the west, and a closet to the north.

>e
Offices
This room is the offices for the basic workers, filled with closed work stations. it seems like all are oblivious to what happened in the conference room. It would not help to talk to these guys, so just focus on finding the culprit. The Conference Room is to the south, the Guard's Office is to the east, and the Hallway is to the west.

You can see work stations (closed) here.

>take projector
You can't see any such thing.

>l
Offices
This room is the offices for the basic workers, filled with closed work stations. it seems like all are oblivious to what happened in the conference room. It would not help to talk to these guys, so just focus on finding the culprit. The Conference Room is to the south, the Guard's Office is to the east, and the Hallway is to the west.

You can see work stations (closed) here.

>e
Guard's Office
This is the office of the security guard. Its sparse with only an empty desk and the guard. The Offices is to the west.

You can see guard here.

>w
Offices
This room is the offices for the basic workers, filled with closed work stations. it seems like all are oblivious to what happened in the conference room. It would not help to talk to these guys, so just focus on finding the culprit. The Conference Room is to the south, the Guard's Office is to the east, and the Hallway is to the west.

You can see work stations (closed) here.

>w
Hallway
This is just the regular hallway in between most elevators and rooms. The Elevator is to the east, Offices to the west, and a closet to the north.

>w
Elevator
The elevator going to other floors, but its locked, so this seems to be a dead end. The Hallway is to the east.

You can see Projector here.

>w
You can't go that way.

I beg your pardon?

>w
You can't go that way.

>w
You can't go that way.

>s
You can't go that way.

>e
Hallway
This is just the regular hallway in between most elevators and rooms. The Elevator is to the east, Offices to the west, and a closet to the north.

>w
Elevator
The elevator going to other floors, but its locked, so this seems to be a dead end. The Hallway is to the east.

You can see Projector here.

>ne
You can't go that way.

>se
You can't go that way.

>sw
You can't go that way.

>nw
You can't go that way.

>n
You can't go that way.

>w
You can't go that way.

>i
You are carrying nothing.

>n
You can't go that way.

>x crystal
You can't see any such thing.

>combine crystal with base
You can't see any such thing.

>combine powered machine with base
You can't see any such thing.

>i
You are carrying nothing.

>combine a powered machine with projector
You can't see any such thing.

>i
You are carrying nothing.

>l
Elevator
The elevator going to other floors, but its locked, so this seems to be a dead end. The Hallway is to the east.

You can see Projector here.

>x imagecaster
You can't see any such thing.

>turn imagecaster on
You can't see any such thing.

>x imagecaster
You can't see any such thing.

>l
Elevator
The elevator going to other floors, but its locked, so this seems to be a dead end. The Hallway is to the east.

You can see Projector here.

>e
Hallway
This is just the regular hallway in between most elevators and rooms. The Elevator is to the east, Offices to the west, and a closet to the north.

>n
Closet
This is just a dark closet, not much is in here besides a closed mop bucket. The Hallway is to the south.

You can see mop bucket (closed) here.

>take spell note
You can't see any such thing.

>x spell note
You can't see any such thing.

>portasum openab
The words were said correctly, but it seems that they also need the source material of the spell to channel magic through while .

>n
There is no where to go.

* * *

>e
Meeting Room
The Meeting room is a secondary room to meet in if the Conference room is being used, it only has a locker to hold stuff. The Conference room is to the west, and Security room to the east.

You can see Security Door here.

>e
(first opening Security Door)
The door is sealed shut and seems like opens only when the correct combination is spun in the spin dial at once. You must SPIN THE DIAL TO the correct 4 digit code.

>w
Conference Room
The room, meant to be your next step in the Magicorp ladder, is now strewn with the bodies of the dead board members with only one living witness in the corner. You will need to find out exactly what happened. Maybe ask the witness about the murders? The Meeting room is to the east and Offices to the north.

You can see witness here.

* * *

>n
Offices
This room is the offices for the basic workers, filled with closed work stations. it seems like all are oblivious to what happened in the conference room. It would not help to talk to these guys, so just focus on finding the culprit. The Conference Room is to the south, the Guard's Office is to the east, and the Hallway is to the west.

You can see work stations (closed) here.

>n
You can't go that way.

>w
Hallway
This is just the regular hallway in between most elevators and rooms. The Elevator is to the west, Offices to the east, and a closet to the north.

>n
The door to the closet, there really seems to be no need to go in there right now though.

>e
Offices
This room is the offices for the basic workers, filled with closed work stations. it seems like all are oblivious to what happened in the conference room. It would not help to talk to these guys, so just focus on finding the culprit. The Conference Room is to the south, the Guard's Office is to the east, and the Hallway is to the west.

You can see work stations (closed) here.

>open work stations
You open work stations, revealing Crystal.

* * *

>take crystal
Taken.

>s
Conference Room
The room, meant to be your next step in the Magicorp ladder, is now strewn with the bodies of the dead board members with only one living witness in the corner. You will need to find out exactly what happened. Maybe ask the witness about the murders? The Meeting room is to the east and Offices to the north.

You can see witness here.

>e
Meeting Room
The Meeting room is a secondary room to meet in if the Conference room is being used, it only has a locker to hold stuff. The Conference room is to the west, and Security room to the east.

You can see Security Door here.

* * *

>take base
Taken.

>e
(first opening Security Door)
The door is sealed shut and seems like opens only when the correct combination is spun in the spin dial at once. You must SPIN THE DIAL TO the correct 4 digit code.

>n
You can't go that way.

>e
(first opening Security Door)
The door is sealed shut and seems like opens only when the correct combination is spun in the spin dial at once. You must SPIN THE DIAL TO the correct 4 digit code.

>e
(first opening Security Door)
The door is sealed shut and seems like opens only when the correct combination is spun in the spin dial at once. You must SPIN THE DIAL TO the correct 4 digit code.

* * *

>w
Conference Room
The room, meant to be your next step in the Magicorp ladder, is now strewn with the bodies of the dead board members with only one living witness in the corner. You will need to find out exactly what happened. Maybe ask the witness about the murders? The Meeting room is to the east and Offices to the north.

You can see witness here.

>n
Offices
This room is the offices for the basic workers, filled with closed work stations. it seems like all are oblivious to what happened in the conference room. It would not help to talk to these guys, so just focus on finding the culprit. The Conference Room is to the south, the Guard's Office is to the east, and the Hallway is to the west.

You can see work stations (empty) here.

>w
Hallway
This is just the regular hallway in between most elevators and rooms. The Elevator is to the west, Offices to the east, and a closet to the north.

>w
Elevator
The elevator going to other floors, but its locked, so this seems to be a dead end. The Hallway is to the east.

You can see Projector here.

* * *

>take projector
Taken.

>e
Hallway
This is just the regular hallway in between most elevators and rooms. The Elevator is to the west, Offices to the east, and a closet to the north.

>n
The door to the closet, there really seems to be no need to go in there right now though.

>combine base with project
You can't see any such thing.

>combine base wit projector
I didn't understand that sentence.

>combine base with projector
You fuse together Base and Projector.

You now have a an Empty machine.

>combine machine with crystal
You fuse together the Empty machine and Crystal.

You now have a Imagecaster.

* * *

>x imagecaster
Imagecaster is currently switched off.

>turn on imagecaster
You switch Imagecaster on.

>x imagecaster
 You see the murder run into the Conference room, and after finishing what he did in there, he ran through the offices into the hallway and went into the closet. He must have escaped through there!

Imagecaster is currently switched on.

* * *

>take crystal
Taken.

>w
Hallway
This is just the regular hallway in between most elevators and rooms. The Elevator is to the west, Offices to the east, and a closet to the north.

>n
You have no reason to go inside.

>w
Elevator
The elevator going to other floors, but its locked, so this seems to be a dead end. The Hallway is to the east.

You can see Projector here.

* * *

>e
Hallway
This is just the regular hallway in between most elevators and rooms. The Elevator is to the west, Offices to the east, and a closet to the north.

>combine base with crystal
You fuse together Base and Crystal.

You now have a a Powered machine.

* * *

>combine machine with projector
You fuse together the Powered machine and Projector.

You now have a Imagecaster.

>n
Closet
This is just a dark closet, not much is in here besides a closed mop bucket. The Hallway is to the south.

You can see mop bucket (closed) here.

* * *

>x witness
A shivering office worker who's suit is splattered with the blood of the deceased. You could ask him about the murders to find out what happened

>ask about the murders
You can't see any such thing.

>ask about murderers
You can't see any such thing.

>ask about what happened
You can't see any such thing.

>ask about murders
You can't see any such thing.

>ask witness about murders
"I was behind a board member as it happened, but I saw that a figure clad in black rushed in and started casting spells of black magic to kill every one. Oh I can't even try to describe how they died. I did not see who it was, but he ran off north to the Offices, the Security Room to the east might have video of where he went though."

>l
Conference Room
The room ment to be your next step in the Magicorp ladder, now strewn with the bodies of the dead board members with only one living witness in the corner. You will need to find out exactly what happened. Maybe ask the witness about the murders? The Meeting room is to the east and Offices to the north.

You can see witness here.

>e
Meeting Room
The Meeting room is a secondary room to meet in if the Conference room is being used, it only has a locker to hold stuff. The Conference room is to the west, and Security room to the east.

You can see Security Door here.

>x locker
A locker used to store items in. Some times people forget things in there, so make sure you don't

In locker is Base.

>take base
Taken.

>x base
The base of the Imagecaster, it needs to be combined with the other parts. You will need to find the 2 other parts and combine them.

>l
Meeting Room
The Meeting room is a secondary room to meet in if the Conference room is being used, it only has a locker to hold stuff. The Conference room is to the west, and Security room to the east.

You can see Security Door here.

>x security door
A locked door protecting the Security room. It seems to be locked with a charmed spin dial so magic can not unlock it. The only way to get inside is to SPIN TO a 4 digit code all at once. The guard in the Guard's Office might know what it is.

>l
Meeting Room
The Meeting room is a secondary room to meet in if the Conference room is being used, it only has a locker to hold stuff. The Conference room is to the west, and Security room to the east.

You can see Security Door here.

>e
(first opening Security Door)
The door is sealed shut and seems like opens only when the correct combination is spun in the spin dial at once. You must SPIN THE DIAL TO the correct 4 digit code.

>w
Conference Room
The room ment to be your next step in the Magicorp ladder, now strewn with the bodies of the dead board members with only one living witness in the corner. You will need to find out exactly what happened. Maybe ask the witness about the murders? The Meeting room is to the east and Offices to the north.

You can see witness here.

>n
Offices
This room is the offices for the basic workers, filled with closed work stations. it seems like all are oblivious to what happened in the conference room. It would not help to talk to these guys, so just focus on finding the culprit. The Conference Room is to the south, the Guard's Office is to the east, and the Hallway is to the west.

You can see work stations (in which is Crystal) here.

>x work stations
In work stations is Crystal.

>e
Guard's Office
This is the office of the security guard. Its sparse with only an empty desk and the guard. The Offices is to the west.

You can see guard here.

>ask gaurd about code
You can't see any such thing.

>ask guard about code
Hi, I remember you, your that new rising worker, but why do you need to know the code for the security door, aren't you suppose to be in a meeting with the board members? Wait, what? Dead? All of them?

>yes
That was a rhetorical question.

>s
You can't go that way.

>e
You can't go that way.

>n
You can't go that way.

>l
Guard's Office
This is the office of the security guard. Its sparse with only an empty desk and the guard. The Offices is to the west.

You can see guard here.

>e
You can't go that way.

>w
Offices
This room is the offices for the basic workers, filled with closed work stations. it seems like all are oblivious to what happened in the conference room. It would not help to talk to these guys, so just focus on finding the culprit. The Conference Room is to the south, the Guard's Office is to the east, and the Hallway is to the west.

You can see work stations (in which is Crystal) here.

>s
Conference Room
The room ment to be your next step in the Magicorp ladder, now strewn with the bodies of the dead board members with only one living witness in the corner. You will need to find out exactly what happened. Maybe ask the witness about the murders? The Meeting room is to the east and Offices to the north.

You can see witness here.

* * *

>e
Meeting Room
The Meeting room is a secondary room to meet in if the Conference room is being used, it only has a locker to hold stuff. The Conference room is to the west, and Security room to the east.

You can see Security Door here.

>spin dial to 2657
The door unlocks and glides open

>yes
That was a rhetorical question.

>w
Conference Room
The room ment to be your next step in the Magicorp ladder, now strewn with the bodies of the dead board members with only one living witness in the corner. You will need to find out exactly what happened. Maybe ask the witness about the murders? The Meeting room is to the east and Offices to the north.

You can see witness here.

>e
Meeting Room
The Meeting room is a secondary room to meet in if the Conference room is being used, it only has a locker to hold stuff. The Conference room is to the west, and Security room to the east.

You can see Security Door here.

>e
(first opening Security Door)

Security Room
This room holds security for the entire building. The Imagecaster would have seen what happened. The Meeting room is to the west.

You can see Security Door here.

>x imagecaster\
You can't see any such thing.

>x imagecaster
You can't see any such thing.

>x Imagecaster
You can't see any such thing.

>l
Security Room
This room holds security for the entire building. The Imagecaster would have seen what happened. The Meeting room is to the west.

You can see Security Door here.

>w
Meeting Room
The Meeting room is a secondary room to meet in if the Conference room is being used, it only has a locker to hold stuff. The Conference room is to the west, and Security room to the east.

You can see Security Door here.

>x locker
A locker used to store items in. Some times people forget things in there, so make sure you don't

>e
Security Room
This room holds security for the entire building. The Imagecaster would have seen what happened. The Meeting room is to the west.

You can see Security Door here.

>w
Meeting Room
The Meeting room is a secondary room to meet in if the Conference room is being used, it only has a locker to hold stuff. The Conference room is to the west, and Security room to the east.

You can see Security Door here.

>w
Conference Room
The room ment to be your next step in the Magicorp ladder, now strewn with the bodies of the dead board members with only one living witness in the corner. You will need to find out exactly what happened. Maybe ask the witness about the murders? The Meeting room is to the east and Offices to the north.

You can see witness here.

* * *

>n
Offices
This room is the offices for the basic workers, filled with closed work stations. it seems like all are oblivious to what happened in the conference room. It would not help to talk to these guys, so just focus on finding the culprit. The Conference Room is to the south, the Guard's Office is to the east, and the Hallway is to the west.

You can see work stations (in which is Crystal) here.

>w
Hallway
This is just the regular hallway in between most elevators and rooms. The Elevator is to the east, Offices to the west, and a closet to the north.

>n
Closet
This is just a dark closet, not much is in here besides a closed mop bucket. The Hallway is to the south.

You can see mop bucket (in which is Spell Note) here.

>x spell note
A scroll with a low level portal spell that even you could cast, it says "portasum openab.

>take note
Taken.

>n
There is no where to go.

>s
Hallway
This is just the regular hallway in between most elevators and rooms. The Elevator is to the east, Offices to the west, and a closet to the north.

>e
Elevator
The elevator going to other floors, but its locked, so this seems to be a dead end. The Hallway is to the east.

You can see Projector here.

>x projector
The projector of the Imagecaster. Just combine it with the 2 other parts.

>take projector
Taken.

>i
You are carrying:
  Projector
  Spell Note
  Base

>e
Hallway
This is just the regular hallway in between most elevators and rooms. The Elevator is to the east, Offices to the west, and a closet to the north.

>e
Elevator
The elevator going to other floors, but its locked, so this seems to be a dead end. The Hallway is to the east.

>e
Hallway
This is just the regular hallway in between most elevators and rooms. The Elevator is to the east, Offices to the west, and a closet to the north.

I beg your pardon?

>n
Closet
This is just a dark closet, not much is in here besides a closed mop bucket. The Hallway is to the south.

You can see mop bucket (empty) here.

>s
Hallway
This is just the regular hallway in between most elevators and rooms. The Elevator is to the east, Offices to the west, and a closet to the north.

>s
You can't go that way.

>w
Elevator
The elevator going to other floors, but its locked, so this seems to be a dead end. The Hallway is to the east.

>w
Hallway
This is just the regular hallway in between most elevators and rooms. The Elevator is to the east, Offices to the west, and a closet to the north.

>w
Elevator
The elevator going to other floors, but its locked, so this seems to be a dead end. The Hallway is to the east.

>e
Hallway
This is just the regular hallway in between most elevators and rooms. The Elevator is to the east, Offices to the west, and a closet to the north.

>n
Closet
This is just a dark closet, not much is in here besides a closed mop bucket. The Hallway is to the south.

You can see mop bucket (empty) here.

* * *

>s
Hallway
This is just the regular hallway in between most elevators and rooms. The Elevator is to the east, Offices to the west, and a closet to the north.

>e
Elevator
The elevator going to other floors, but its locked, so this seems to be a dead end. The Hallway is to the east.

>w
Hallway
This is just the regular hallway in between most elevators and rooms. The Elevator is to the east, Offices to the west, and a closet to the north.

* * *

>w
Elevator
The elevator going to other floors, but its locked, so this seems to be a dead end. The Hallway is to the east.

>s
You can't go that way.

* * *

>x witness
A shivering office worker who's suit is splattered with the blood of the deceased. You could ask him about the murders to find out what happened

>ask witness about murder
There is no reply.

>talk to witness
Try asking about something instead.

>ask witness
(for witness)
(witness first taking witness)
Witness has better things to do.

>i
You are carrying nothing.

>ask witness about murders
"I was behind a board member as it happened, but I saw that a figure clad in black rushed in and started casting spells of black magic to kill every one. Oh I can't even try to describe how they died. I did not see who it was, but he ran off north to the Offices, the Security Room to the east might have video of where he went though."

>e
Meeting Room
The Meeting room is a secondary room to meet in if the Conference room is being used, it only has a locker to hold stuff. The Conference room is to the west, and Security room to the east.

You can see Security Door here.

>w
Conference Room
The room meant to be your next step in the Magicorp ladder, now strewn with the bodies of the dead board members with only one living witness in the corner. You will need to find out exactly what happened. Maybe ask the witness about the murders? The Meeting room is to the east and Offices to the north.

You can see witness here.

>n
Offices
This room is the offices for the basic workers, filled with closed work stations. it seems like all are oblivious to what happened in the conference room. It would not help to talk to these guys, so just focus on finding the culprit. The Conference Room is to the south, the Guard's Office is to the east, and the Hallway is to the west.

You can see work stations (closed) here.

>s
Conference Room
The room meant to be your next step in the Magicorp ladder, now strewn with the bodies of the dead board members with only one living witness in the corner. You will need to find out exactly what happened. Maybe ask the witness about the murders? The Meeting room is to the east and Offices to the north.

You can see witness here.

>s
You can't go that way.

>w
You can't go that way.

* * *

>e
(first opening Security Door)
The door is sealed shut and seems like opens only when the correct combination is spun in the spin dial at once. You must SPIN THE DIAL TO the correct 4 digit code.

>w
Conference Room
The room meant to be your next step in the Magicorp ladder, now strewn with the bodies of the dead board members with only one living witness in the corner. You will need to find out exactly what happened. Maybe ask the witness about the murders? The Meeting room is to the east and Offices to the north.

You can see witness here.

>w
You can't go that way.

* * *

>e
Meeting Room
The Meeting room is a secondary room to meet in if the Conference room is being used, it only has a locker to hold stuff. The Conference room is to the west, and Security room to the east.

You can see Security Door here.

>s
You can't go that way.

>n
You can't go that way.

>s
You can't go that way.

>e
(first opening Security Door)
The door is sealed shut and seems like opens only when the correct combination is spun in the spin dial at once. You must SPIN THE DIAL TO the correct 4 digit code.

* * *

>n
You can't go that way.

>w
Conference Room
The room meant to be your next step in the Magicorp ladder, now strewn with the bodies of the dead board members with only one living witness in the corner. You will need to find out exactly what happened. Maybe ask the witness about the murders? The Meeting room is to the east and Offices to the north.

You can see witness here.

* * *

>n
Offices
This room is the offices for the basic workers, filled with closed work stations. it seems like all are oblivious to what happened in the conference room. It would not help to talk to these guys, so just focus on finding the culprit. The Conference Room is to the south, the Guard's Office is to the east, and the Hallway is to the west.

You can see work stations (closed) here.

>e
Guard's Office
This is the office of the security guard. Its sparse with only an empty desk and the guard. The Offices is to the west.

You can see guard here.

>talk to guard
Try asking about something instead.

>ask guard about passwor
There is no reply.

>ask guard about password
There is no reply.

>ask guard about passcode
There is no reply.

>x desk
A regular wooden desk with nothing on it. Its rather boring.

>x guard
He is a stern looking man in the blue guard uniform and sunglasses. He is in charge of the security on this level. He would know the spin dial code to the Security room, you could ask him about it.

>ask guard about dial code
There is no reply.

>ask guard about spin dial code
There is no reply.

>ask guard about code
Hi, I remember you, your that new rising worker, but why do you need to know the code for the security door, aren't you suppose to be in a meeting with the board members?
Wait, what? Dead?
All of them?
Of course I'll help you, we need to find this murderer fast! The code is this year, so just spin the dial to 2657.

>e
You can't go that way.

>w
Offices
This room is the offices for the basic workers, filled with closed work stations. it seems like all are oblivious to what happened in the conference room. It would not help to talk to these guys, so just focus on finding the culprit. The Conference Room is to the south, the Guard's Office is to the east, and the Hallway is to the west.

You can see work stations (closed) here.

>s
Conference Room
The room meant to be your next step in the Magicorp ladder, now strewn with the bodies of the dead board members with only one living witness in the corner. You will need to find out exactly what happened. Maybe ask the witness about the murders? The Meeting room is to the east and Offices to the north.

You can see witness here.

* * *

>e
(first opening Security Door)
The door is sealed shut and seems like opens only when the correct combination is spun in the spin dial at once. You must SPIN THE DIAL TO the correct 4 digit code.

>2657
That's not a verb I recognise.

>spin the dial to 2657
The door unlocks and glides open

>e
(first opening Security Door)

Security Room
This room holds security for the entire building. The Imagecaster would have seen what happened, but it seems to be missing! The dust around where it should be suggests that it was broken apart though, the murderer must have done this to cover his tracks! You will need to find the missing peaces and combine them back into an Imagecaster so you can see how the murderer escaped. The Meeting room is to the west.

You can see Security Door here.

>x door
A locked door protecting the Security room. It seems to be locked with a charmed spin dial so magic can not unlock it. The only way to get inside is to SPIN TO a 4 digit code all at once. The guard in the Guard's Office might know what it is.

>x dust
You can't see any such thing.

>w
Meeting Room
The Meeting room is a secondary room to meet in if the Conference room is being used, it only has a locker to hold stuff. The Conference room is to the west, and Security room to the east.

You can see Security Door here.

>w
Conference Room
The room meant to be your next step in the Magicorp ladder, now strewn with the bodies of the dead board members with only one living witness in the corner. You will need to find out exactly what happened. Maybe ask the witness about the murders? The Meeting room is to the east and Offices to the north.

You can see witness here.

* * *

>w
You can't go that way.

>n
Offices
This room is the offices for the basic workers, filled with closed work stations. it seems like all are oblivious to what happened in the conference room. It would not help to talk to these guys, so just focus on finding the culprit. The Conference Room is to the south, the Guard's Office is to the east, and the Hallway is to the west.

You can see work stations (closed) here.

>talk to workers
You can't see any such thing.

>open stations
You open work stations, revealing Crystal.

>take crystal
Taken.

>i
You are carrying:
  Crystal

>x crystal
The power crystal of the an Imagecaster. Combine it with the other 2 parts to make the Imagecaster.

>i
You are carrying:
  Crystal

>e
Guard's Office
This is the office of the security guard. Its sparse with only an empty desk and the guard. The Offices is to the west.

You can see guard here.

>w
Offices
This room is the offices for the basic workers, filled with closed work stations. it seems like all are oblivious to what happened in the conference room. It would not help to talk to these guys, so just focus on finding the culprit. The Conference Room is to the south, the Guard's Office is to the east, and the Hallway is to the west.

You can see work stations (empty) here.

>w
Hallway
This is just the regular hallway in between most elevators and rooms. The Elevator is to the west, Offices to the east, and a closet to the north.

* * *

>w
Elevator
The elevator going to other floors, but its locked, so this seems to be a dead end. The Hallway is to the east.

You can see Projector here.

>e
Hallway
This is just the regular hallway in between most elevators and rooms. The Elevator is to the west, Offices to the east, and a closet to the north.

>n
Closet
This is just a dark closet, not much is in here besides a closed mop bucket. The Hallway is to the south.

You can see mop bucket (closed) here.

>open bucket
You open mop bucket, revealing Spell Note.

>take spell note
Taken.

>x spell note
A scroll with a low level portal spell that even you could cast, it says "portasum openab."

>s
Hallway
This is just the regular hallway in between most elevators and rooms. The Elevator is to the west, Offices to the east, and a closet to the north.

>w
Elevator
The elevator going to other floors, but its locked, so this seems to be a dead end. The Hallway is to the east.

You can see Projector here.

* * *

>take projector
Taken.

>i
You are carrying:
  Projector
  Spell Note
  Crystal

>e
Hallway
This is just the regular hallway in between most elevators and rooms. The Elevator is to the west, Offices to the east, and a closet to the north.

>e
Offices
This room is the offices for the basic workers, filled with closed work stations. it seems like all are oblivious to what happened in the conference room. It would not help to talk to these guys, so just focus on finding the culprit. The Conference Room is to the south, the Guard's Office is to the east, and the Hallway is to the west.

You can see work stations (empty) here.

>e
Guard's Office
This is the office of the security guard. Its sparse with only an empty desk and the guard. The Offices is to the west.

You can see guard here.

>e
You can't go that way.

>w
Offices
This room is the offices for the basic workers, filled with closed work stations. it seems like all are oblivious to what happened in the conference room. It would not help to talk to these guys, so just focus on finding the culprit. The Conference Room is to the south, the Guard's Office is to the east, and the Hallway is to the west.

You can see work stations (empty) here.

>s
Conference Room
The room meant to be your next step in the Magicorp ladder, now strewn with the bodies of the dead board members with only one living witness in the corner. You will need to find out exactly what happened. Maybe ask the witness about the murders? The Meeting room is to the east and Offices to the north.

You can see witness here.

>e
Meeting Room
The Meeting room is a secondary room to meet in if the Conference room is being used, it only has a locker to hold stuff. The Conference room is to the west, and Security room to the east.

You can see Security Door here.

>x locker
A locker used to store items in. Some times people forget things in there, so make sure you don't leave anything behind.

>open locker
You open locker, revealing Base.

* * *

>take base
Taken.

>i
You are carrying:
  Base
  Projector
  Spell Note
  Crystal

>combine base and projector
You can't use multiple objects with that verb.

>combine base
What do you want to combine Base with?

>projector
You fuse together Base and Projector.

You now have a an Empty machine.

>i
You are carrying:
  an Empty machine
  Spell Note
  Crystal

>combine empty machine
What do you want to combine the Empty machine with?

>with crystal
You can't see any such thing.

>combine machine
What do you want to combine the Empty machine with?

>crystal
You fuse together the Empty machine and Crystal.

You now have a Imagecaster.

>e
Security Room
This room holds security for the entire building. The Imagecaster would have seen what happened, but it seems to be missing! The dust around where it should be suggests that it was broken apart though, the murderer must have done this to cover his tracks! You will need to find the missing peaces and combine them back into an Imagecaster so you can see how the murderer escaped. The Meeting room is to the west.

You can see Security Door here.

>use imagecaster
That's not a verb I recognise.

>drop imagecaster
Dropped.

>undo
Security Room
[Previous turn undone.]

>open imagecaster
It isn't something you can open.

>look at imagecaster
Imagecaster is currently switched off.

>turn on imagecaster
You switch Imagecaster on.

* * *

>x imagecaster
 You see the murder run into the Conference room, and after finishing what he did in there, he ran through the offices into the hallway and went into the closet. He must have escaped through there!

Imagecaster is currently switched on.

>undo
Security Room
[Previous turn undone.]

>x imagecaster
 You see the murder run into the Conference room, and after finishing what he did in there, he ran through the offices into the hallway and went into the closet. He must have escaped through there!

Imagecaster is currently switched on.

* * *

>undo
Security Room
[Previous turn undone.]

>undo
Security Room
[Previous turn undone.]

>x imagecaster
Imagecaster is currently switched off.

* * *

>x imagecaster
 You see the murder run into the Conference room, and after finishing what he did in there, he ran through the offices into the hallway and went into the closet. He must have escaped through there!

Imagecaster is currently switched on.

>e
You can't go that way.

>w
Meeting Room
The Meeting room is a secondary room to meet in if the Conference room is being used, it only has a locker to hold stuff. The Conference room is to the west, and Security room to the east.

You can see Security Door here.

* * *

>w
Conference Room
The room meant to be your next step in the Magicorp ladder, now strewn with the bodies of the dead board members with only one living witness in the corner. You will need to find out exactly what happened. Maybe ask the witness about the murders? The Meeting room is to the east and Offices to the north.

You can see witness here.

>n
Offices
This room is the offices for the basic workers, filled with closed work stations. it seems like all are oblivious to what happened in the conference room. It would not help to talk to these guys, so just focus on finding the culprit. The Conference Room is to the south, the Guard's Office is to the east, and the Hallway is to the west.

You can see work stations (empty) here.

>n
You can't go that way.

>e
Guard's Office
This is the office of the security guard. Its sparse with only an empty desk and the guard. The Offices is to the west.

You can see guard here.

* * *

>w
Hallway
This is just the regular hallway in between most elevators and rooms. The Elevator is to the west, Offices to the east, and a closet to the north.

>n
Closet
This is just a dark closet, not much is in here besides a closed mop bucket. The Hallway is to the south.

You can see mop bucket (empty) here.

>n
There is no where to go.

>x spell note
A scroll with a low level portal spell that even you could cast, it says "portasum openab."

>portasum openab
In a clap of thunder and a bright flash, a glowing portal appears to the north.

>n
(first opening Void Portal)
Dark Arts Inc
Dark Arts Inc is Magicorp's biggest rival, of course they would send some one to sabotage you.

    *** The portal sucks you in, and you find your self in a lobby, filled with many people in both dark suits and black magician robes. Oh, no. This is Dark Arts Inc, Magicorp's biggest rival in techno magic innovation! This can only mean this was an act of sabotage! ***

Would you like to RESTART, RESTORE a saved game, QUIT or UNDO the last command?

* * *

>tak note
That's not a verb I recognise.

>take note
Taken.

>n
Offices
This room is the offices for the basic workers, filled with cubical like work stations. it seems like all are oblivious to what happened in the conference room. It would not help to talk to these guys, so just focus on finding the culprit. The Conference Room is to the south, the Guard Office is to the east, and the Hallway is to the west.

>w
Hallway
This is just the regular hallway in between most elevators and rooms. The Elevator is to the east, Offices to the west, and a closet to the north.

>n
Closet
This is just a dark closet, not much is in here

>n
There is no where to go.

>portasum openab
In a clap of thunder and a bright flash, a glowing portal appears to the north.

>nm
That's not a verb I recognise.

>n
(first opening Void Portal)
In a clap of thunder and a bright flash, a glowing portal appears to the north.

>n
(first opening Void Portal)
In a clap of thunder and a bright flash, a glowing portal appears to the north.

* * *

>take notes
You can't see any such thing.

>take note
Taken.

* * *

>n
Closet
This is just a dark closet, not much is in here

>n
(first opening Void Portal)
In a clap of thunder and a bright flash, a glowing portal appears to the north.