This is an exiting day! You have been invited by the board to sit in on a conference about the company's newest product for techno magic. As you open the door, your face contorts in horror to find all the Conference Room littered with the unmoving bodies of the board members, killed by magic, and one shivering witness in the corner. This is a tragedy, the company will be thrown into ruin from this loss unless the true murderer can be caught. It is up to you to find the culprit and save Magicorp.

Magicorp
An Interactive Fiction by Cole Damon
Release 1 / Serial number 141024 / Inform 7 build 6L38 (I6/v6.33 lib 6/12N) SD

Conference Room
The room ment to be your next step in the Magicorp ladder, now strewn with the bodies of the dead board members with only one living witness in the corner. You will need to find out exactly what happened. Maybe ask the witness about the murders? The Meeting room is to the east and Offices to the north.

You can see witness here.

>take note
Taken.

* * *

>portasum openab
In a clap of thunder and a bright flash, a glowing portal appears to the north.

>n
(first opening Void Portal)
Dark Arts Inc
Dark Arts Inc is Magicorp's biggest rival, of course they would send some one to sabotage you.

    *** Oh, no. This is Dark Arts Inc, Magicorp's biggest rival in techno magic innovation! This can only mean this was an act of sabotage! ***

Would you like to RESTART, RESTORE a saved game, QUIT or UNDO the last command?

>undo
Closet
[Previous turn undone.]

* * *

>portasum openab
In a clap of thunder and a bright flash, a glowing portal appears to the north.

>x portal
Dark Arts Inc
Dark Arts Inc is Magicorp's biggest rival, of course they would send some one to sabotage you.

    *** Oh, no. This is Dark Arts Inc, Magicorp's biggest rival in techno magic innovation! This can only mean this was an act of sabotage! ***

Would you like to RESTART, RESTORE a saved game, QUIT or UNDO the last command?

* * *

>n
There is no where to go.

>portasum obenab
I didn't understand that sentence.

>portasum openab
In a clap of thunder and a bright flash, a glowing portal appears to the north.

>n
(first opening Void Portal)
In a clap of thunder and a bright flash, a glowing portal appears to the north.

* * *

>n
Closet
This is just a dark closet, not much is in here

>portasum openab
In a clap of thunder and a bright flash, a glowing portal appears to the north.

>n
(first opening Void Portal)

*** Run-time problem P61: Attempt to move the player off-stage.

* * *

>take note
Taken.

>take all
That would make things to easy, try to have some fun :)

>n
Offices
This room is the offices for the basic workers, filled with cubical like work stations. it seems like all are oblivious to what happened in the conference room. It would not help to talk to these guys, so just focus on finding the culprit. The Conference Room is to the south, the Guard Office is to the east, and the Hallway is to the west.

>e
Guard Office

>w
Offices
This room is the offices for the basic workers, filled with cubical like work stations. it seems like all are oblivious to what happened in the conference room. It would not help to talk to these guys, so just focus on finding the culprit. The Conference Room is to the south, the Guard Office is to the east, and the Hallway is to the west.

>w
Hallway
This is just the regular hallway in between most elevators and rooms. The Elevator is to the east, Offices to the west, and a closet to the north.

* * *

>n
Closet
This is just a dark closet, not much is in here

>say portasum openab
In a clap of thunder and a bright flash, a glowing portal appears to the north.

* * *

>n
Offices
This room is the offices for the basic workers, filled with cubical like work stations. it seems like all are oblivious to what happened in the conference room. It would not help to talk to these guys, so just focus on finding the culprit. The Conference Room is to the south, the Guard Office is to the east, and the Hallway is to the west.

* * *

>n
There is no where to go.

>say portasum openab
The words were said correctly, but it seems that they also need the source material of the spell to channel magic through while .

* * *

>take all
That would make things to easy, try to have some fun :)

* * *

>take notes
You can't see any such thing.

* * *

>tak note
That's not a verb I recognise.